0000000000
0#00000#00
0000000000
0000S00000
000SES0000
0000SS0000
0000000000
0#00000#00
0000000000
0000000000