0000000000
0000000000
00######00
00#0000#00
00#0ES0000
0000SS0#00
00#0SS0#00
00######00
0000000000
0000000000