0000000000
00######00
00######00
00#0S00#00
000SES0000
0000SS0000
00#0000#00
00######00
00######00
0000000000