####00####
#00000000#
#0L0000L0#
#00000000#
0000$00000
00000$0000
#00000000#
#0L0000L0#
#00000000#
####00####