##########
#00000000#
#0L0000L0#
#00000000#
#00000000#
#00000000#
#00000000#
#0L0LL0L0#
#00000000#
##########