0000000000
0000##0000
#L00##0000
#000000L00
0000000000
#000000L00
#000000000
#L0000##00
000000##00
0000000000