0000000000
00L000L0L0
000####000
000####000
000####000
000###L000
000####000
000####000
00L0000000
0000000000