0000000000
0###00###0
0#000000#0
0#00LL00#0
00000000#0
00000000#0
0#000000#0
0#L0000L#0
0########0
0000000000