##########
00#L000000
00#0000000
00#0000000
00#0000#00
00#0000#00
00#0000#00
0000000#00
000000L#00
##########