0000000000
0########0
0#00$00L#0
0#00000000
0#$00000#0
0#####0##0
0#L00000#0
0#0000L0#0
0#0######0
0000000000