0000000000
0########0
0#000000#0
0#00000000
0#000000#0
0#####0##0
0#000000#0
0#000000#0
0#0######0
0000000000