0000L00000
0########0
0#000L00#0
0#$$0#00#0
0#####00#0
0#000000#0
0#0L00###0
0#000000#0
0###00###0
000L00L000