0000000000
000L000000
00#0000#00
0000000000
0000L00000
00000L0000
0000000000
00#0000#00
0000000000
00000L0000