0L00000000
000######0
00000000#0
00000L00#0
00000000#0
00000000#0
00000000#0
0000000L00
00L0000000
0000000000