0000000000
0000000000
00######00
0000L00000
0000000000
0000000000
0000L00000
00######00
0000000000
0000000000