0000000000
0000000000
L0######00
0000L00000
0000000000
0000000000
0000L00000
00######00
000000L000
0000000000