000000####
000000#000
000000#000
000000#000
000000#000
000#00#000
000#000000
000#000000
000#000000
####000000