000000####
000000#000
00L000#000
000000#000
000000#000
000#LL#000
000#000000
000#000L00
000#000000
####000000