000000####
000000#000
000000#000
000000#000
000000#000
000#LL#000
000#000000
000#000000
000#000000
####000000