0000000L00
00#0000#00
00L0000000
00#0000#00
0000000000
00#0000#00
0000000L00
00#0000#00
000L000000
00#0000#00