0000000000
0#0#0#0#0#
L000000000
0000000000
0000000L00
000L000000
0000000000
0000000000
0#0#0#0#0#
0000000000