0000000000
00#L000000
0000000000
0000000000
#####0####
#00000000#
#0$000000#
#0LL00$$0#
#00000000#
##########