0000000000
00#0000000
0000000000
0000000000
#####0####
#00000000#
#0$000000#
#00000$$0#
#00000000#
##########