0000000000
000L000000
00######00
00#000L#00
00#0$00#00
00#0000#00
0L#0000#00
00###0##00
00000L0000
0000000000