0000000000
0000000000
00######00
00#0000#00
00#0$00#00
00#0000#00
00#0000#00
00###0##00
0000000000
0000000000