0000000000
0000000000
000#0#0#00
0000000000
000#0X0#00
0000000000
000#0#0#00
0000000000
0000000000
0000000000
