0000000000
0000000000
000#####00
000#000#00
00000X0#00
000#000#00
000#####00
0000000000
0000000000
0000000000
